ai	avoir
as	avoir
a	avoir
avons	avoir
avez	avoir
ont	avoir
avais	avoir
avait	avoir
avions	avoir
aviez	avoir
avaient	avoir


suis	être
es	être
est	être
sommes	être
êtes	être
sont	être
étais	être
était	être
étions	être
étiez	être
étaient	être
--été


allons	aller
vais	aller
venus	venus

voulons	vouloir
voulais	voulais

faites	faire
fais	faire
faisons	faire

pouvons	pouvoir
pouvais	pouvais

devons	devoir
dois	devoir

sais	savoir

crois	croire

vois	voir

rappelons	rappeler

travaillons	travailler

demandons	demander

aimerais	aimer

dis	dire

